#########
#       #
####C####
#       #
#########