#################
#       #       #
# ## ## # ## ## #
#               #
# ## # ### # ## #
#    #  #  #    #
#### ## # ## ####
#### # GGG # ####
                 
#### ## # ## ####
#    #  #  #    #
# ## # ### # ## #
#       C       #
# ## ## # ## ## #
#       #       #
#################